1111111
10E0111
101C101
1P10001
1111111