1111111111111111111111111111111
100P00000000000000000001C100001
10000C010000100100C000011100001
10000C010000100100C000000000001
10000C010000100100C000000000001
10000C010000100100C000000000001
1000000100C0000100000000E000001
1111111111111111111111111111111